"patientID","numBiopsies","numMutations","numDriverMutations","numClonesWithDriver","numTruncalMutations","numSubclonalMutations"
"BE_AH_061",3,1137,10,6,94,1043
"BE_AH_086",4,668,10,4,190,478
"BE_AH_100",4,157,10,3,114,43
"BE_AH_111",5,657,10,5,72,585
"BE_AH_135",5,1023,12,7,59,964
"BE_AH_169",2,278,4,3,62,216
"BE_AH_248",2,518,8,4,80,438
"BE_AH_252",4,463,7,4,47,416
"BE_AH_277",4,997,12,6,69,928
"BE_AH_282",3,705,9,5,135,570
"BE_AH_374",3,133,2,2,48,85
"BE_AH_408",5,368,6,4,113,255
"BE_AH_412",2,265,7,4,14,251
"BE_AH_414",3,357,3,2,134,223
"BE_AH_418",6,432,9,6,144,288
"BE_AH_450",4,457,6,4,75,382
"BE_AH_464",5,404,7,5,86,318
"BE_AH_468",5,295,1,1,86,209
"BE_AH_471",4,274,3,2,72,202
"BE_AH_489",3,316,6,1,211,105
"BE_AH_545",5,379,3,1,134,245
"BE_AH_637",4,186,5,2,93,93
"BE_ED_082",3,412,5,3,139,273
"BE_ED_110",5,802,7,3,443,359
"BE_ED_113",4,402,8,4,38,364
"BE_ED_136",5,674,12,5,60,614
"BE_ED_143",5,650,10,4,188,462
"BE_ED_147",5,343,9,4,82,261
"BE_NT_076",5,618,11,4,89,529
"BE_NT_210",5,359,5,3,94,265
"BE_NT_278",5,365,9,6,101,264
"BE_NT_302",5,480,6,3,156,324
"BE_NT_324",5,453,6,4,46,407
"BE_NT_341",4,255,4,3,99,156
"BE_NT_362",5,372,5,4,200,172
"BE_PL_056",5,636,11,5,137,499
"BE_PL_058",5,699,14,6,169,530
"BE_PL_069",4,458,9,3,140,318
"BE_PL_085",5,358,1,1,99,259
"BE_PL_111",5,388,6,4,194,194
"BE_PL_147",5,315,5,3,132,183
"BE_PL_158",5,349,1,1,137,212
"BE_PL_176",2,209,6,3,70,139
"BE_PL_177",3,231,4,3,97,134
"BE_PL_182",6,283,3,1,182,101
"BE_PL_183",5,389,5,3,199,190
"BE_PL_188",4,241,4,1,158,83
"BE_PL_199",6,231,5,2,45,186
"BE_QE_077",4,529,6,5,124,405
"BE_QE_094",5,532,5,4,143,389
"BE_QE_130",4,515,5,3,78,437
"BE_QE_152",3,538,15,5,201,337
"BE_QE_173",5,423,3,3,95,328
"BE_QE_181",4,340,7,4,123,217
"BE_QE_235",5,410,1,1,156,254
"BE_SA_022",3,598,6,4,113,485
"BE_SH_166",4,403,6,3,181,222
"BE_SH_220",5,724,12,4,200,524
"BE_SH_233",5,416,6,3,225,191
"BE_SH_325",4,281,5,2,210,71
"Non-BE_AH_213",3,590,6,4,108,482
"Non-BE_AH_218",4,455,10,7,97,358
"Non-BE_AH_437",4,273,5,3,126,147
"Non-BE_AH_518",4,309,6,2,125,184
"Non-BE_AH_574",5,230,5,3,164,66
"Non-BE_AH_612",5,225,2,2,105,120
"Non-BE_ED_045",4,369,5,2,97,272
"Non-BE_ED_051",2,385,10,3,52,333
"Non-BE_ED_122",4,403,4,2,122,281
"Non-BE_ED_139",4,904,8,5,38,866
"Non-BE_NS_019",6,223,4,4,71,152
"Non-BE_NT_139",5,265,5,4,82,183
"Non-BE_NT_143",5,611,5,3,66,545
"Non-BE_NT_171",5,791,13,5,198,593
"Non-BE_NT_314",6,291,7,4,135,156
"Non-BE_NT_342",5,576,7,6,165,411
"Non-BE_NT_350",5,436,4,2,129,307
"Non-BE_NT_369",5,379,10,6,120,259
"Non-BE_PL_020",6,801,8,6,136,665
"Non-BE_PL_067",4,455,7,4,154,301
"Non-BE_PL_082",5,445,4,3,68,377
"Non-BE_PL_123",4,282,3,2,112,170
"Non-BE_PL_169",4,308,2,2,40,268
"Non-BE_PL_193",5,272,4,1,159,113
"Non-BE_PL_196",4,257,8,4,98,159
"Non-BE_SA_081",5,517,6,4,117,400
"Non-BE_SH_058",4,410,6,1,204,206
"Non-BE_SH_159",2,254,6,2,135,119
"Non-BE_SH_326",3,299,7,4,115,184
